########################################
##....................................##
#....................----------------..#
#....................----------------..#
#..................................--..#
#....................-.............--..#
#....................-.............--..#
#....................-.............--..#
#....................----------------..#
#....................----------------..#
#.......................----------.....#
#......................................#
#......................................#
#......................................#
#......................................#
#......................................#
#......................................#
#......................................#
##....................................##
########################################
